{
  "name": "Prototype Yard",
  "width": 20,
  "height": 14,
  "tile_size": 32,
  "player_spawn": {
    "x": 2,
    "y": 2
  },
  "npcs": [
    {
      "id": "guide",
      "name": "Guide",
      "dialogue": "data/guide_dialogue.json",
      "spawn": {
        "x": 5,
        "y": 3
      },
      "sprite": {
        "width": 22,
        "height": 30,
        "origin_x": 11,
        "origin_y": 26
      },
      "palette": {
        "body": { "r": 74, "g": 61, "b": 54 },
        "outfit": { "r": 178, "g": 194, "b": 170 },
        "accent": { "r": 115, "g": 86, "b": 44 },
        "skin": { "r": 214, "g": 172, "b": 139 }
      }
    }
  ],
  "items": [
    {
      "id": "stimpak",
      "spawn": {
        "x": 8,
        "y": 4
      }
    },
    {
      "id": "vault_canteen",
      "spawn": {
        "x": 12,
        "y": 9
      }
    }
  ],
  "tiles": [
    1, 1, 1, 1, 1, 1, 1, 1, 1, 1, 1, 1, 1, 1, 1, 1, 1, 1, 1, 1,
    1, 0, 0, 0, 0, 0, 0, 0, 0, 0, 0, 0, 0, 0, 0, 0, 0, 0, 0, 1,
    1, 0, 0, 0, 0, 0, 0, 0, 0, 0, 0, 0, 0, 0, 0, 0, 0, 0, 0, 1,
    1, 0, 0, 0, 0, 0, 0, 0, 0, 0, 0, 0, 0, 0, 0, 0, 0, 0, 0, 1,
    1, 0, 0, 0, 0, 0, 0, 0, 0, 0, 1, 1, 1, 0, 0, 0, 0, 0, 0, 1,
    1, 0, 0, 0, 0, 0, 0, 0, 0, 0, 0, 0, 1, 0, 0, 0, 0, 0, 0, 1,
    1, 0, 0, 0, 0, 0, 0, 0, 0, 0, 0, 0, 1, 0, 0, 0, 0, 0, 0, 1,
    1, 0, 0, 0, 0, 0, 0, 0, 0, 0, 0, 0, 1, 0, 0, 0, 0, 0, 0, 1,
    1, 0, 0, 0, 0, 0, 0, 0, 0, 0, 0, 0, 0, 0, 0, 0, 0, 0, 0, 1,
    1, 0, 0, 0, 0, 0, 0, 0, 0, 0, 0, 0, 0, 0, 0, 0, 0, 0, 0, 1,
    1, 0, 0, 0, 0, 0, 0, 0, 0, 0, 0, 0, 0, 0, 0, 0, 0, 0, 0, 1,
    1, 0, 0, 0, 0, 0, 0, 0, 0, 0, 0, 0, 0, 0, 0, 0, 0, 0, 0, 1,
    1, 0, 0, 0, 0, 0, 0, 0, 0, 0, 0, 0, 0, 0, 0, 0, 0, 0, 0, 1,
    1, 1, 1, 1, 1, 1, 1, 1, 1, 1, 1, 1, 1, 1, 1, 1, 1, 1, 1, 1
  ]
}
